1111111111111
1000000000001
1000000C00001
10000P0000001
1000000000001
1000000E00001
1000000000001
1111111111111