1111111111111
10C10000000C1
100001000C001
1P0C01E000001
1101111110111
1101101000011
1101101111011
1100001000011
11111C1011011
11111011C0011
1111111111111